##########
 #S  #   #
 # # #####
 # #     #
 ### #####
 #       #
 # ### ###
 # #     #
#### # # #
 #   # # #
 # # ### #
 # # #   #
## # #####
   #     #
## # # # #
 # # # # #
 # # ### #
 # # #   #
 # ### ###
 #E#     #
